NO ./textures/hasbu.xpm
SO ./textures/hasbu.xpm
WE ./textures/hasbu.xpm
EA ./textures/hasbu.xpm

F 0,0,0
C 0,0,0

1111111111111111111111111
1000000000110000000000001
101100000111000000N000001
1001000000000000000000001
11111111111111111111111111
11111111 1111111 111111111111