NO ./textures/shrek.xpm
SO ./textures/shrek.xpm
WE ./textures/shrek.xpm
EA ./textures/shrek.xpm

C 101,105,50
F 230,154,243

1111111111111111111111111111111111111111111111111111
100100100100100100100100100100100100100100100110011
110010010010010010010010010010010010010011001100111
100100100100100100100100100100100100100100100110011
110010010010010010010010010010010010010011001100111
100100100100100100100100100100100100100100100110011
100100100100100100100100100100100100100100100110011
100100100100100100100100100100100100100100100110011
110010010010010010010010010010010010010011001100111
10010010010010010010010010N100100100100100100110011
100100100100100100100100100100100100100100100110011
110010010010010010010010010010010010010011001100111
101000000000000000000000000000000000000000000000011
101000011100000000000000111011000000000000000000011
101000000000000101010101010010000000000000000000011
101000000000000101010101010010000000000000000000011
101000000000000101010101010010000000000000000000011
101000000000000101010101010010000000000000000000001
111111111111111111111111111111111111111111111111111