NO ./textures/north.xpm
SO ./textures/south.xpm
WE ./textures/west.xpm
EA ./textures/east.xpm

F 256,100,0
C 123,45,23

1111111111111111111111111111111111111111111111111111
100000000000000000000000000000000000000000000000001
100000000000000000000000000000000000111100000000001
100000011100000000000000111011000001100111000000011
100000000000000101010101010010000001000001000000001
100000000110000000000000000000000000000001000000001
100010111011000000100111110000000000001101010000001
100000000000000000000111110001000001110100010000001
100000000000000000001111110001000000010000010000001
100000000000000000000000000001000000010000010000001
100000001100000000000000000001000000000000010000001
100000000100000000000000111100000000000100000000001
100010001000000000000000111100010000000000000000001
100000000000000000000000111100000000000000000000001
100000010000000000000000000000000000011010100000011
100000000000000000000000000000000000011111100000001
100000000000000000000000000000000000011  1010000S01
1111111111111111111111111111111111111111 1111111111