NO ./textures/north.xpm
SO ./textures/south.xpm
WE ./textures/west.xpm
EA ./textures/east.xpm

F 220,100,0
C 225,30,123

11111111111111
11N110001
100000001
100000001
100000001
11111111111111