NO ./textures/north.xpm
SO ./textures/south.xpm
WE ./textures/west.xpm
EA ./textures/east.xpm

F 220,100,0
C 225,30,123

1111111111111111111111111
1110000000000000000000001
1110000000000001110000001
11100000E0000001110000001
1110000000001001110010001
1110000000000000100000001
1111111111111111111111111