NO ./textures/north.xpm
SO ./textures/south.xpm
WE ./textures/west.xpm
EA ./textures/east.xpm

F 220,100,0
C 225,30,123

1111111111111111111111111111111111111111111111111111
100000000000000000000000000000000000000000000000001
100000000000000000000000000000000000000000000000001
100000011100000000000000111011000000000000000000001
100000000000000101010101010010000000000000000000001
100000000110000000000000000000000000000000000000001
100010111011000000100000000000000000000000000000001
100000000000000000000000000001000000000000000000001
100000000000000000000000000001000000000000000000001
100000000000000000000000000001000000000000000000001
100000001100000000000000000001000000000000000000001
100000000100000000000000000000000000000000000000001
100010001000000000000000000000000000000000000000001
100000000000000000000000000000000000000000000000001
100000010000000000000000000000000000000000000000001
100000000000000000000000000000000000000000000000001
10000000000000000000000E000000000000000000000000001
111111111111111111111111111111111111111111111111111