NO ./textures/north.xpm
SO ./textures/south.xpm
WE ./textures/west.xpm
EA ./textures/east.xpm

F 220,100,0
C 225,30,123

11111111111111
110000000001
100000011111
10000001111
1000N000111111111
10000000011110001
11111111111111111