NO ./textures/north.xpm
SO ./textures/south.xpm
WE ./textures/west.xpm
EA ./textures/east.xpm

F 220,100,0
C 225,30,123

11111111111111
1101100011111111111
1000001000000000001
10001000011000000111111
1000000N00000010001
1111111111111111111